1111111111111
10010000P00C1
100P011111001
110011E000001
1111111111111