1111111111111
1F01000E000C1
1000011111001
1P0F11E00F001
1111111111111